"year","state","arrivals","departures","nom","grouping","erp","depart_rate"
2004,"nsw",23630,36060,-12430,"australian",6669206,0.00540694049636493
2004,"vic",15760,23150,-7390,"australian",4957147,0.00467002491554114
2004,"qld",14170,18730,-4560,"australian",3872351,0.00483685492353353
2004,"sa",3510,4980,-1470,"australian",1532562,0.00324946070697303
2004,"wa",7690,10580,-2890,"australian",1994241,0.00530527654380789
2004,"tas",930,1280,-350,"australian",484778,0.00264038384580158
2004,"nt",730,920,-190,"australian",203857,0.00451296742324276
2004,"act",1700,2860,-1160,"australian",329498,0.00867987059102028
2004,"all",68130,98550,-30420,"australian",20046003,0.00491619202092307
2004,"nsw",128980,83010,45970,"total",6669206,0.0124467590294857
2004,"vic",84780,45710,39070,"total",4957147,0.00922102975764084
2004,"qld",67110,41170,25940,"total",3872351,0.0106317841538642
2004,"sa",16290,8900,7390,"total",1532562,0.0058072691349518
2004,"wa",39840,22950,16890,"total",1994241,0.0115081376824566
2004,"tas",3430,2140,1290,"total",484778,0.00441439174219952
2004,"nt",4980,3750,1230,"total",203857,0.0183952476490873
2004,"act",5610,4580,1030,"total",329498,0.0138999326247807
2004,"all",351010,212220,138790,"total",20046003,0.0105866491190289
2005,"nsw",25110,33620,-8510,"australian",6718023,0.00500444848134637
2005,"vic",17460,20970,-3510,"australian",5023203,0.00417462722490013
2005,"qld",14580,17390,-2810,"australian",3964175,0.00438678918059874
2005,"sa",3750,4380,-630,"australian",1544852,0.00283522305049286
2005,"wa",8530,9530,-1000,"australian",2029936,0.00469472929195797
2005,"tas",1040,1140,-100,"australian",488098,0.00233559654003909
2005,"nt",600,860,-260,"australian",207385,0.00414687658220218
2005,"act",1890,2790,-900,"australian",333505,0.00836569166879057
2005,"all",72960,90660,-17700,"australian",20311543,0.00446347182978664
2005,"nsw",130480,79680,50800,"total",6718023,0.0118606322127805
2005,"vic",85370,45200,40170,"total",5023203,0.00899824275467267
2005,"qld",70280,40480,29800,"total",3964175,0.0102114563559883
2005,"sa",19000,8480,10520,"total",1544852,0.00548919896533778
2005,"wa",44160,21580,22580,"total",2029936,0.0106308770325764
2005,"tas",3250,2020,1230,"total",488098,0.00413851316743769
2005,"nt",3990,2870,1120,"total",207385,0.0138389951057212
2005,"act",5660,4690,970,"total",333505,0.0140627576797949
2005,"all",362180,205000,157180,"total",20311543,0.0100927832021427
2006,"nsw",26530,34470,-7940,"australian",6786160,0.00507945583363787
2006,"vic",17530,21830,-4300,"australian",5103965,0.00427706694697162
2006,"qld",15870,17040,-1170,"australian",4055845,0.00420134398627166
2006,"sa",3970,4280,-310,"australian",1561300,0.00274130532248767
2006,"wa",8480,9580,-1100,"australian",2076867,0.00461271713595526
2006,"tas",980,1070,-90,"australian",491515,0.00217694271792316
2006,"nt",680,840,-160,"australian",211029,0.00398049557169868
2006,"act",1970,2690,-720,"australian",338381,0.00794961892068408
2006,"all",76010,91800,-15790,"australian",20627547,0.00445035951196718
2006,"nsw",140230,78210,62020,"total",6786160,0.0115249272047815
2006,"vic",97900,45550,52350,"total",5103965,0.00892443423887115
2006,"qld",78060,39670,38390,"total",4055845,0.00978094577085663
2006,"sa",22320,8900,13420,"total",1561300,0.00570037789021969
2006,"wa",49990,21920,28070,"total",2076867,0.0105543590417682
2006,"tas",3410,2030,1380,"total",491515,0.00413008758634019
2006,"nt",4090,3750,340,"total",211029,0.0177700695165119
2006,"act",6140,4640,1500,"total",338381,0.0137123538260127
2006,"all",402140,204650,197490,"total",20627547,0.00992119906453249
2007,"nsw",24730,36570,-11840,"australian",6883852,0.00531243263219488
2007,"vic",16670,23000,-6330,"australian",5199503,0.0044234997075682
2007,"qld",15240,18070,-2830,"australian",4159990,0.00434376044173183
2007,"sa",3780,4740,-960,"australian",1578489,0.00300287173366428
2007,"wa",8230,10240,-2010,"australian",2135006,0.0047962394485074
2007,"tas",960,1150,-190,"australian",495858,0.00231921235515006
2007,"nt",790,820,-30,"australian",216618,0.0037854656584402
2007,"act",1950,2710,-760,"australian",344176,0.00787387848077728
2007,"all",72340,97300,-24960,"australian",21016121,0.00462977920616274
2007,"nsw",157740,80850,76890,"total",6883852,0.0117448777225309
2007,"vic",114620,48150,66470,"total",5199503,0.00926050047475691
2007,"qld",91950,44270,47680,"total",4159990,0.0106418525044531
2007,"sa",23490,9660,13830,"total",1578489,0.0061197765711386
2007,"wa",58170,23740,34430,"total",2135006,0.011119406690192
2007,"tas",3530,2060,1470,"total",495858,0.00415441517531229
2007,"nt",4500,3130,1370,"total",216618,0.0144493994035583
2007,"act",6580,4700,1880,"total",344176,0.0136558040072521
2007,"all",460580,216550,244030,"total",21016121,0.0103039947286181
2008,"nsw",27540,33800,-6260,"australian",7001782,0.00482734252508861
2008,"vic",18700,21290,-2590,"australian",5313285,0.00400693732784897
2008,"qld",15820,16610,-790,"australian",4275551,0.00388487939916984
2008,"sa",4120,4180,-60,"australian",1597880,0.00261596615515558
2008,"wa",9030,9010,20,"australian",2208928,0.00407890162105782
2008,"tas",1080,1040,40,"australian",501774,0.00207264625110109
2008,"nt",670,890,-220,"australian",222526,0.00399953263888265
2008,"act",2220,2680,-460,"australian",351101,0.00763313120725945
2008,"all",79160,89500,-10340,"australian",21475625,0.00416751549722069
2008,"nsw",178560,82130,96430,"total",7001782,0.0117298710528263
2008,"vic",133000,49770,83230,"total",5313285,0.00936708646345905
2008,"qld",106900,44060,62840,"total",4275551,0.0103051045350646
2008,"sa",27160,9540,17620,"total",1597880,0.00597041079430245
2008,"wa",72850,24660,48190,"total",2208928,0.0111637862347709
2008,"tas",4270,2180,2090,"total",501774,0.00434458541096191
2008,"nt",5190,3220,1970,"total",222526,0.0144702192103395
2008,"act",8040,4710,3330,"total",351101,0.0134149432784299
2008,"all",535970,220280,315690,"total",21475625,0.0102572102092489
2009,"nsw",28430,30170,-1740,"australian",7101504,0.00424839583277007
2009,"vic",18770,18790,-20,"australian",5419249,0.00346727009591181
2009,"qld",16090,15280,810,"australian",4367454,0.00349860582389649
2009,"sa",4260,3560,700,"australian",1618578,0.00219946150262762
2009,"wa",8630,8550,80,"australian",2263747,0.00377692383468647
2009,"tas",1050,950,100,"australian",506461,0.00187576141104646
2009,"nt",1000,880,120,"australian",227783,0.00386332606032935
2009,"act",2290,2540,-250,"australian",357859,0.00709776755649571
2009,"all",80520,80720,-200,"australian",21865623,0.00369163961164061
2009,"nsw",155060,84900,70160,"total",7101504,0.011955213994106
2009,"vic",123840,51750,72090,"total",5419249,0.00954929363828826
2009,"qld",94200,46880,47320,"total",4367454,0.0107339424754102
2009,"sa",26810,9630,17180,"total",1618578,0.00594966692986066
2009,"wa",60960,28120,32840,"total",2263747,0.01242188283408
2009,"tas",4110,2180,1930,"total",506461,0.00430437881692766
2009,"nt",5230,3540,1690,"total",227783,0.0155411071063249
2009,"act",8560,4890,3670,"total",357859,0.0136645997445921
2009,"all",478790,231890,246900,"total",21865623,0.0106052317832426
2010,"nsw",27940,32800,-4860,"australian",7179891,0.0045683144771975
2010,"vic",18680,20530,-1850,"australian",5495711,0.00373564039302649
2010,"qld",15380,16070,-690,"australian",4436882,0.00362191286583686
2010,"sa",3610,4010,-400,"australian",1632482,0.00245638236746255
2010,"wa",9230,9210,20,"australian",2319063,0.00397143156524855
2010,"tas",990,1030,-40,"australian",510219,0.00201874097201398
2010,"nt",640,880,-240,"australian",230299,0.00382111950117022
2010,"act",2060,2640,-580,"australian",364833,0.00723618751593195
2010,"all",78510,87170,-8660,"australian",22172469,0.00393145210846839
2010,"nsw",141230,91180,50050,"total",7179891,0.0126993571350874
2010,"vic",102810,59600,43210,"total",5495711,0.0108448206246653
2010,"qld",82310,50640,31670,"total",4436882,0.0114134205056614
2010,"sa",21910,11010,10900,"total",1632482,0.0067443316373473
2010,"wa",60980,29080,31900,"total",2319063,0.0125395472223049
2010,"tas",3740,2510,1230,"total",510219,0.00491945615510202
2010,"nt",4590,3510,1080,"total",230299,0.0152410561921676
2010,"act",7550,5550,2000,"total",364833,0.0152124396641751
2010,"all",425120,253080,172040,"total",22172469,0.0114141550947709
2011,"nsw",27480,32420,-4940,"australian",7258722,0.00446635096370959
2011,"vic",18920,20370,-1450,"australian",5591818,0.00364282242376272
2011,"qld",14610,15480,-870,"australian",4518649,0.00342580271227086
2011,"sa",3420,3610,-190,"australian",1647183,0.00219162048175582
2011,"wa",8460,9340,-880,"australian",2385947,0.00391458821172474
2011,"tas",840,930,-90,"australian",511739,0.00181733266372115
2011,"nt",720,810,-90,"australian",232952,0.00347711116453175
2011,"act",2170,2500,-330,"australian",372070,0.00671916574838068
2011,"all",76640,85450,-8810,"australian",22522197,0.00379403483594429
2011,"nsw",141580,87410,54170,"total",7258722,0.0120420647050541
2011,"vic",109070,58010,51060,"total",5591818,0.0103740858518643
2011,"qld",88960,48040,40920,"total",4518649,0.0106314962724478
2011,"sa",20980,10540,10440,"total",1647183,0.00639880329022337
2011,"wa",70680,27400,43280,"total",2385947,0.0114839097431754
2011,"tas",3580,2330,1250,"total",511739,0.00455310226502182
2011,"nt",5710,3640,2070,"total",232952,0.0156255365912291
2011,"act",8460,5410,3050,"total",372070,0.0145402746794958
2011,"all",449020,242780,206240,"total",22522197,0.0107795877995384
2012,"nsw",27260,30620,-3360,"australian",7353189,0.00416417965048906
2012,"vic",19030,19800,-770,"australian",5709586,0.00346785213498842
2012,"qld",14100,14860,-760,"australian",4611304,0.00322251580030291
2012,"sa",3390,3750,-360,"australian",1663082,0.00225484973080101
2012,"wa",8180,9210,-1030,"australian",2457489,0.00374772786368525
2012,"tas",860,960,-100,"australian",511813,0.00187568506466229
2012,"nt",760,730,30,"australian",238728,0.00305787339566368
2012,"act",2280,2490,-210,"australian",379812,0.00655587501184797
2012,"all",75870,82420,-6550,"australian",22928023,0.00359472772685198
2012,"nsw",144960,81820,63140,"total",7353189,0.0111271449707059
2012,"vic",115990,57230,58760,"total",5709586,0.0100234938224943
2012,"qld",94890,47630,47260,"total",4611304,0.0103289655160449
2012,"sa",22740,10860,11880,"total",1663082,0.00653004482039972
2012,"wa",79310,29350,49960,"total",2457489,0.0119430849944801
2012,"tas",3860,2280,1580,"total",511813,0.00445475202857294
2012,"nt",7490,3370,4120,"total",238728,0.0141164840320365
2012,"act",9120,5560,3560,"total",379812,0.0146388213115963
2012,"all",478350,238110,240240,"total",22928023,0.0103851082145198
2013,"nsw",26950,32930,-5980,"australian",7454938,0.00441720642076433
2013,"vic",18720,21670,-2950,"australian",5832585,0.00371533376710327
2013,"qld",14500,16920,-2420,"australian",4685439,0.00361118776703741
2013,"sa",3450,3840,-390,"australian",1678052,0.00228836770255034
2013,"wa",8340,10530,-2190,"australian",2502188,0.00420831688106569
2013,"tas",940,900,40,"australian",513015,0.00175433466857694
2013,"nt",770,870,-100,"australian",242304,0.00359053090332805
2013,"act",2150,2790,-640,"australian",386318,0.00722202951972209
2013,"all",75810,90450,-14640,"australian",23297777,0.00388234465459945
2013,"nsw",157160,89570,67590,"total",7454938,0.0120148551201901
2013,"vic",121650,63150,58500,"total",5832585,0.0108271032483881
2013,"qld",88570,55110,33460,"total",4685439,0.0117619715036307
2013,"sa",23700,11570,12130,"total",1678052,0.0068948995621113
2013,"wa",67450,38390,29060,"total",2502188,0.0153425721808273
2013,"tas",4150,2360,1790,"total",513015,0.00460025535315732
2013,"nt",7250,4060,3190,"total",242304,0.0167558108821976
2013,"act",8750,6110,2640,"total",386318,0.0158159857940867
2013,"all",478680,270310,208370,"total",23297777,0.0116023945117167
2014,"nsw",25570,33260,-7690,"australian",7562171,0.00439820786914234
2014,"vic",18000,22930,-4930,"australian",5957512,0.00384892216750885
2014,"qld",13330,17770,-4440,"australian",4747263,0.00374320950829983
2014,"sa",3290,4100,-810,"australian",1693107,0.00242158351480444
2014,"wa",7420,11000,-3580,"australian",2528619,0.00435020064311784
2014,"tas",900,960,-60,"australian",514040,0.0018675589448292
2014,"nt",710,880,-170,"australian",242753,0.00362508393305129
2014,"act",2080,2820,-740,"australian",391981,0.00719422625076215
2014,"all",71300,93720,-22420,"australian",23640331,0.00396441149660722
2014,"nsw",156990,88640,68350,"total",7562171,0.0117215016692958
2014,"vic",124310,65920,58390,"total",5957512,0.0110650217741903
2014,"qld",79940,56910,23030,"total",4747263,0.011987960220447
2014,"sa",22810,11830,10980,"total",1693107,0.00698715438539915
2014,"wa",55310,39800,15510,"total",2528619,0.0157398168723718
2014,"tas",4230,2510,1720,"total",514040,0.004882888491168
2014,"nt",5850,4710,1140,"total",242753,0.019402437868945
2014,"act",9310,6100,3210,"total",391981,0.0155619787693791
2014,"all",458760,276410,182350,"total",23640331,0.0116923066770935
2015,"nsw",25880,34750,-8870,"australian",7671401,0.00452981143861467
2015,"vic",18320,24360,-6040,"australian",6093049,0.00399799837486946
2015,"qld",14110,19310,-5200,"australian",4804933,0.00401878652626374
2015,"sa",3350,4470,-1120,"australian",1705937,0.00262026088888394
2015,"wa",7680,11760,-4080,"australian",2547745,0.0046158465623522
2015,"tas",780,1060,-280,"australian",515694,0.00205548251482468
2015,"nt",720,900,-180,"australian",244090,0.00368716457044533
2015,"act",2290,2920,-630,"australian",398874,0.00732060751014105
2015,"all",73120,99520,-26400,"australian",23984581,0.00414933243987043
2015,"nsw",164230,91390,72840,"total",7671401,0.0119130781978416
2015,"vic",132710,68520,64190,"total",6093049,0.0112456013401501
2015,"qld",79920,60440,19480,"total",4804933,0.0125787393913713
2015,"sa",23550,12300,11250,"total",1705937,0.00721011385531822
2015,"wa",52470,39720,12750,"total",2547745,0.0155902572667202
2015,"tas",4040,2620,1420,"total",515694,0.00508053225362327
2015,"nt",6880,5340,1540,"total",244090,0.0218771764513089
2015,"act",9460,6190,3270,"total",398874,0.0155186850985524
2015,"all",473250,286520,186730,"total",23984581,0.0119460081458167
2016,"nsw",27480,33110,-5630,"australian",7795625,0.00424725406878858
2016,"vic",19790,22950,-3160,"australian",6235781,0.00368037299578032
2016,"qld",15210,17980,-2770,"australian",4882939,0.00368220860428525
2016,"sa",3550,4340,-790,"australian",1719580,0.00252387210830552
2016,"wa",8660,12010,-3350,"australian",2569606,0.00467386828953544
2016,"tas",880,940,-60,"australian",521981,0.00180083183104366
2016,"nt",690,840,-150,"australian",246065,0.00341373214394571
2016,"act",2410,2820,-410,"australian",408878,0.00689692279848757
2016,"all",78670,94980,-16310,"australian",24385064,0.00389500720605039
2016,"nsw",186750,90550,96200,"total",7795625,0.0116154894572276
2016,"vic",150750,67850,82900,"total",6235781,0.0108807541509235
2016,"qld",86130,53700,32430,"total",4882939,0.0109974750862134
2016,"sa",23990,11890,12100,"total",1719580,0.00691447911699368
2016,"wa",50620,38650,11970,"total",2569606,0.0150412164355158
2016,"tas",4610,2330,2280,"total",521981,0.00446376400673588
2016,"nt",6790,4710,2080,"total",246065,0.0191412838071241
2016,"act",10000,6150,3850,"total",408878,0.0150411614222335
2016,"all",519650,275820,243830,"total",24385064,0.0113110221896485
2017,"nsw",26930,32790,-5860,"australian",7900946,0.00415013594574624
2017,"vic",20320,22320,-2000,"australian",6358210,0.00351042195838137
2017,"qld",15260,17550,-2290,"australian",4960965,0.00353761818517164
2017,"sa",3680,4120,-440,"australian",1735654,0.00237374499756288
2017,"wa",8630,11020,-2390,"australian",2599928,0.00423857891449302
2017,"tas",890,900,-10,"australian",531561,0.00169312647090362
2017,"nt",680,1010,-330,"australian",246862,0.00409135468399349
2017,"act",2410,2720,-310,"australian",420226,0.00647270754308396
2017,"all",78810,92460,-13650,"australian",24759018,0.00373439689732444
2017,"nsw",194410,99490,94920,"total",7900946,0.0125921630144036
2017,"vic",159710,72580,87130,"total",6358210,0.0114151624435179
2017,"qld",86410,58780,27630,"total",4960965,0.0118485012492529
2017,"sa",23700,11600,12100,"total",1735654,0.00668335970187606
2017,"wa",45730,34030,11700,"total",2599928,0.013088823998203
2017,"tas",4910,2340,2570,"total",531561,0.00440212882434942
2017,"nt",5880,4640,1240,"total",246862,0.0187959264690394
2017,"act",10560,6210,4350,"total",420226,0.0147777624421145
2017,"all",531370,289710,241660,"total",24759018,0.0117011910569313
2018,"nsw",26080,30970,-4890,"australian",8003564,0.00386952612611082
2018,"vic",19440,20770,-1330,"australian",6479695,0.00320539778492661
2018,"qld",14930,15910,-980,"australian",5046434,0.0031527213077591
2018,"sa",3530,3820,-290,"australian",1755715,0.00217575175925478
2018,"wa",8180,9630,-1450,"australian",2636404,0.00365270269655182
2018,"tas",880,870,10,"australian",542927,0.00160242537210343
2018,"nt",540,940,-400,"australian",245920,0.00382238126219909
2018,"act",2380,2570,-190,"australian",430758,0.00596622697663189
2018,"all",75990,85480,-9490,"australian",25146140,0.00339932888308106
2018,"nsw",192490,99600,92890,"total",8003564,0.0124444559948543
2018,"vic",163520,73980,89540,"total",6479695,0.0114172040504993
2018,"qld",87540,53800,33740,"total",5046434,0.010660993485697
2018,"sa",24910,10950,13960,"total",1755715,0.00623677533084812
2018,"wa",44700,30150,14550,"total",2636404,0.0114360318069613
2018,"tas",5490,2330,3160,"total",542927,0.00429155300804712
2018,"nt",5180,4630,550,"total",245920,0.018827260897853
2018,"act",10530,6710,3820,"total",430758,0.01557719183393
2018,"all",534400,282180,252220,"total",25146140,0.0112216029975177
2019,"nsw",32920,29640,3280,"australian",8088361,0.00366452486480265
2019,"vic",23500,21800,1700,"australian",6590050,0.00330801738985288
2019,"qld",18710,15680,3030,"australian",5129741,0.00305668453826421
2019,"sa",4550,3680,870,"australian",1778928,0.00206866157596035
2019,"wa",10800,8770,2030,"australian",2688799,0.0032616792850637
2019,"tas",1140,750,390,"australian",553340,0.00135540535656197
2019,"nt",660,990,-330,"australian",246213,0.00402090872537193
2019,"act",2710,2270,440,"australian",440267,0.00515596217749684
2019,"all",95020,83590,11430,"australian",25520468,0.00327541015313669
2019,"nsw",208820,129540,79280,"total",8088361,0.0160156056338237
2019,"vic",185730,100670,85060,"total",6590050,0.0152760601209399
2019,"qld",102080,68160,33920,"total",5129741,0.0132872205438832
2019,"sa",30820,14170,16650,"total",1778928,0.00796547134004299
2019,"wa",56850,31350,25500,"total",2688799,0.0116594806826393
2019,"tas",7230,3260,3970,"total",553340,0.00589149528318936
2019,"nt",5600,4600,1000,"total",246213,0.0186830102391019
2019,"act",10700,8470,2230,"total",440267,0.0192383258340961
2019,"all",607870,360250,247620,"total",25520468,0.0141161204410515
2020,"nsw",29530,14810,14720,"australian",8094300,0.00182968261616199
2020,"vic",12370,12000,370,"australian",6567195,0.00182726415158983
2020,"qld",11950,7370,4580,"australian",5184329,0.00142159187813891
2020,"sa",2950,1740,1210,"australian",1794514,0.000969621858620217
2020,"wa",6860,4320,2540,"australian",2728187,0.00158346916835246
2020,"tas",700,390,310,"australian",561881,0.000694097148684508
2020,"nt",360,410,-50,"australian",247819,0.00165443327589894
2020,"act",1910,1430,480,"australian",447650,0.00319445995755613
2020,"all",66660,42490,24170,"australian",25630698,0.00165777771639305
2020,"nsw",91330,84400,6930,"total",8094300,0.0104270906687422
2020,"vic",59750,80120,-20370,"total",6567195,0.0122000336521148
2020,"qld",37900,38920,-1020,"total",5184329,0.00750723960612839
2020,"sa",12910,8850,4060,"total",1794514,0.00493169738436145
2020,"wa",23730,18540,5190,"total",2728187,0.00679572184751265
2020,"tas",2730,2100,630,"total",561881,0.00373744618522427
2020,"nt",2180,2120,60,"total",247819,0.00855463059733112
2020,"act",4780,5260,-480,"total",447650,0.0117502513124092
2020,"all",235350,240320,-4970,"total",25630698,0.00937625654986064
2021,"nsw",26860,20060,6800,"australian",8101223,0.00247616933887636
2021,"vic",14080,14360,-280,"australian",6566092,0.00218699342013484
2021,"qld",9750,8410,1340,"australian",5261012,0.00159855176152421
2021,"sa",2500,2080,420,"australian",1805733,0.00115188679610995
2021,"wa",5490,5190,300,"australian",2763015,0.00187838285351328
2021,"tas",550,450,100,"australian",568628,0.000791378546255197
2021,"nt",530,430,100,"australian",248125,0.00173299748110831
2021,"act",1790,2300,-510,"australian",452670,0.00508096405770208
2021,"all",61570,53270,8300,"australian",25771357,0.00206702347881798
2021,"nsw",88160,76260,11900,"total",8101223,0.00941339350860975
2021,"vic",58640,64190,-5550,"total",6566092,0.00977598242607627
2021,"qld",32460,33250,-790,"total",5261012,0.00632007682172175
2021,"sa",9410,8300,1110,"total",1805733,0.0045964713498618
2021,"wa",16480,17690,-1210,"total",2763015,0.00640242633499999
2021,"tas",3210,1770,1440,"total",568628,0.00311275561527044
2021,"nt",2950,2230,720,"total",248125,0.00898740554156171
2021,"act",4770,5540,-770,"total",452670,0.0122384960346389
2021,"all",216110,209240,6870,"total",25771357,0.00811909128417258
2022,"nsw",23090,33610,-10520,"australian",8249295,0.00407428756033091
2022,"vic",17110,22580,-5470,"australian",6719487,0.00336037557629027
2022,"qld",12830,16240,-3410,"australian",5386914,0.00301471306206114
2022,"sa",2880,3690,-810,"australian",1836096,0.00200969883927638
2022,"wa",7510,9660,-2150,"australian",2834117,0.00340846902227396
2022,"tas",680,900,-220,"australian",572352,0.00157245890640725
2022,"nt",430,860,-430,"australian",251248,0.00342291281920652
2022,"act",1780,2820,-1040,"australian",461126,0.00611546518738913
2022,"all",66360,90400,-24040,"australian",26315575,0.00343522799710818
2022,"nsw",223110,80710,142400,"total",8249295,0.0097838663788845
2022,"vic",189050,58470,130580,"total",6719487,0.0087015571277986
2022,"qld",106830,41190,65640,"total",5386914,0.00764630732920555
2022,"sa",34940,9280,25660,"total",1836096,0.00505420195893897
2022,"wa",66950,22760,44190,"total",2834117,0.00803071997380489
2022,"tas",6680,2510,4170,"total",572352,0.00438541317231354
2022,"nt",6140,3630,2510,"total",251248,0.0144478762019996
2022,"act",12290,5290,7000,"total",461126,0.0114719187380456
2022,"all",646110,223880,422230,"total",26315575,0.00850750933620109
